#######################
#___________________#e#
#___________________#_#
#___________________#_#
#___####_####_________#
#___#__#s#__#_________#
#___####_####_________#
#_____________________#
#_____________________#
#######################


