#######################
s#_#__#_____#__#____#e#
_#_#_##_###_#_##_#_##_#
_____####_____##_#_#__#
_###_#__##__#____#_#_##
_###_#__##_##__#_#_#_##
___#__#_#__##__#_#_#_##
_#_#__#_##_##__#_#_#_##
_#_#___________#_____##
#######################


