#######################
#######################
#######_###############
#######_###############
##_####_###_###########
##e____s_____##########
#######_###_###########
#######################
