#######################
#___________________#e#
#___________________#_#
#___________________#_#
#_____________________#
#_______s_____________#
#_____________________#
#_____________________#
#_____________________#
#######################


